16 1000
........................................................................................................................................................................................................................................................................................................................................................................................................................................................................................................................................................................................................................................................................................................................................................................................................................................................................................................................................................................................................................................
........................................................................................................................................................................................................................................................................................................................................................................................................................................................................................................................................................................................................................................................................................................................................................................................................................................................................................................................................................................................................................................
............................................................................................................................................................................................................................................................................................................................................................................................................................................................................................................................................................................................................................................................................................................................c.c.c..c.c.c................................................................................................................................................................................................................................................................................................
..................................................................................................................................................................................................................................................................................................................................................................................................................................................................................................................................................................K..........k.............................................................................................................................................c.....c.c.....c..............................................................................................................................................................................................................................................................................................
..................................................................................................................................................................................................................................................................................................................................................................................................................................................................................................................................................................####....####..........###......#.....#..#.....#.....###..................................................................................................c......c......c..............................................................................................................................................................................................................................................................................................
.................................................................................................................................................................................................................................................................................................................................................................................................................................................................................................................................................................#....#..#....#........#..g#.....#....k#...#...#.....#...G#.................................................................................................c...........c...............................................................................................................................................................................................................................................................................................
................................................................................................................................................................................................................................................................................................................................................................................................................................................................................................................................................................#......##......#......#######....#######....###.....########..................................................................................................c........c................................................................................................................................................................................................................................................................................................
............................................................g.................................................................................................##..................................................................................................k.........................g..........G....................##.................................................................................................................................................................................................................................#................#....#.......#...#.....#.....#.....#........#...................................................................................................c.....c.................................................................................................................................................................................................................................................................................................
...........g..............####............................ccc...................g...G.......................................k......K......................#.......................................................cc..........................................ccccc####................####ccc...........####..................................................................................................................................................................................................................................................#..................#..#.........#..#.....#.....#....#.........#.....................................................................................................c.c..................................................................................................................................................................................................................................................................................................
..s....G..cccc............####.................................................ccc###................................ccccccc......cccc.........##...........................................................................................................................................................ccccc...............................................................................................................................##..................................................##..........................................................................................................................................................................................###....................................................................................................................................................................................................................................................................###...........................................................e..
.###...#.#................####...............k....g......................................................kg....................................##....kk..#...................#...........gG.....#......GGg.......##........KkK..........##.............................................................................................................................................................Gk.......K.g.............................##.....KK............kk.........G.....g.............##..................................##..............................................................................................................................................................................................................................................................................................................................................................................................................................................................................................
#########################################....########..###################################.#############################################..#################################################################################################################################################################################....#############################....################.....######################...##########################################################################################################################################################################################################################################################################################################################################################################################################################################################################################################################################################################################################################
#########################################...#########..###################################.#############################################..#################################################################################################################################################################################.cc.##############################...#################....######################...##########################################################################################################################################################################################################################################################################################################################################################################################################################################################################################################################################################################################################################
#########################################..##########..###################################.#############################################..#################################################################################################################################################################################....###############################..##################...######################...##########################################################################################################################################################################################################################################################################################################################################################################################################################################################################################################################################################################################################################
#########################################k###########..###################################.#############################################..#################################################################################################################################################################################....################################k###################.g######################...##########################################################################################################################################################################################################################################################################################################################################################################################################################################################################################################################################################################################################################
#####################################################..###################################.#############################################..#################################################################################################################################################################################....############################################################################...##########################################################################################################################################################################################################################################################################################################################################################################################################################################################################################################################################################################################################################
